MERGE_DEFENDERS_LEVEL_V1
20 12
MAP
48 46 46 46 47 46 47 48 46 46 47 46 48 46 46 46 46 46 46 46
18 18 14 42 42 42 12 18 18 18 14 42 42 42 12 18 18 18 14 46
46 46 6 37 37 37 6 38 46 36 6 37 37 37 6 38 47 46 6 46
48 46 6 37 37 37 6 38 46 36 6 37 37 37 6 38 48 46 6 46
46 46 2 20 20 20 4 38 48 36 2 20 20 20 4 38 47 46 2 14
47 47 36 37 37 37 37 38 46 36 37 37 37 37 37 38 46 48 46 6
48 46 12 20 20 20 14 38 46 36 12 20 20 20 14 38 47 47 46 6
46 47 6 37 37 37 6 38 48 36 6 37 37 37 6 38 46 46 12 4
46 46 6 37 37 37 6 38 46 36 6 37 37 37 6 38 46 48 6 46
17 18 4 32 32 32 2 18 18 18 4 32 32 32 2 18 18 18 4 46
46 46 47 46 46 48 46 46 48 46 46 46 48 46 46 46 46 46 46 47
46 46 48 46 47 46 46 46 46 46 47 46 46 47 47 48 47 48 46 46
REGION
0 0 0 0 0 0 0 0 0 0 0 0 0 0 0 0 0 0 0 0
2 7 5 0 0 0 7 7 7 7 5 0 0 0 7 7 7 7 5 0
1 1 5 0 0 0 4 1 1 1 5 0 0 0 4 1 1 1 5 0
1 1 5 0 0 0 4 1 1 1 5 0 0 0 4 1 1 1 5 0
1 1 7 7 7 7 4 1 1 1 7 7 7 7 4 1 1 1 7 5
1 1 0 0 0 0 0 1 1 1 0 0 0 0 0 1 1 1 0 5
1 1 5 6 6 6 6 1 1 1 5 6 6 6 6 1 1 1 0 5
1 1 5 0 0 0 4 1 1 1 5 0 0 0 4 1 1 1 5 6
1 1 5 0 0 0 4 1 1 1 5 0 0 0 4 1 1 1 5 0
3 6 6 0 0 0 4 6 6 6 6 0 0 0 4 6 6 6 6 0
0 0 0 0 0 0 0 0 0 0 0 0 0 0 0 0 0 0 0 0
0 0 0 0 0 0 0 0 0 0 0 0 0 0 0 0 0 0 0 0
