MERGE_DEFENDERS_LEVEL_V1
20 12
MAP
38 46 46 6 25 46 46 46 46 46 46 46 46 46 46 46 46 46 46 46
38 48 46 6 25 46 46 46 46 46 46 46 46 46 46 46 46 47 46 46
38 46 46 6 46 46 46 46 48 46 46 46 46 46 25 25 25 25 46 46
38 46 46 6 46 46 47 46 12 18 18 18 18 18 18 18 18 18 18 19
38 46 46 6 46 46 46 46 6 40 40 40 40 40 46 46 46 46 46 47
38 46 46 6 46 46 46 46 6 40 40 40 40 40 46 46 46 46 46 46
38 46 47 6 46 46 46 46 6 40 40 40 40 40 48 46 46 46 46 46
38 46 46 6 48 46 46 46 6 40 40 40 40 40 46 46 46 46 46 46
38 46 46 6 46 46 46 46 6 40 40 40 40 40 46 46 46 46 46 46
38 46 46 2 18 18 18 18 4 46 46 46 46 46 47 46 46 46 47 46
38 46 46 46 46 46 47 46 46 46 46 46 46 46 25 25 25 25 25 46
26 42 42 42 42 42 42 42 42 42 42 42 42 42 42 42 42 42 42 42
REGION
0 0 0 2 0 0 0 0 0 0 0 0 0 0 0 0 0 0 0 0
0 0 0 5 0 0 0 0 0 0 0 0 0 0 0 0 0 0 0 0
0 0 0 5 0 0 0 0 0 0 0 0 0 0 0 0 0 0 0 0
0 0 0 5 0 0 0 0 7 7 7 7 7 7 7 7 7 7 7 3
0 0 0 5 0 0 0 0 4 1 1 1 1 1 0 0 0 0 0 0
0 0 0 5 0 0 0 0 4 1 1 1 1 1 0 0 0 0 0 0
0 0 0 5 0 0 0 0 4 1 1 1 1 1 0 0 0 0 0 0
0 0 0 5 0 0 0 0 4 1 1 1 1 1 0 0 0 0 0 0
0 0 0 5 0 0 0 0 4 1 1 1 1 1 0 0 0 0 0 0
0 0 0 7 7 7 7 7 4 0 0 0 0 0 0 0 0 0 0 0
0 0 0 0 0 0 0 0 0 0 0 0 0 0 0 0 0 0 0 0
0 0 0 0 0 0 0 0 0 0 0 0 0 0 0 0 0 0 0 0
