MERGE_DEFENDERS_LEVEL_V1
20 12
MAP
47 47 47 47 47 47 47 47 47 47 47 47 47 47 47 47 47 47 47 47
47 47 47 47 47 47 47 47 47 47 47 47 47 47 47 47 47 47 47 47
47 48 48 48 47 48 47 48 47 48 47 48 48 48 48 48 48 48 48 48
48 48 48 48 47 48 48 48 48 48 48 48 48 48 48 48 48 48 48 48
48 48 48 48 48 48 48 48 48 48 48 48 48 48 48 48 48 48 48 48
47 47 47 47 46 46 46 46 47 47 47 47 47 47 47 47 47 47 47 46
46 46 47 47 47 47 47 47 47 47 46 47 46 46 47 47 46 46 46 46
46 47 46 47 47 46 46 47 46 47 47 47 47 47 47 47 47 46 46 46
46 47 47 47 47 47 47 47 47 47 47 47 47 47 47 47 47 47 47 46
46 47 47 47 47 47 47 47 47 47 47 47 47 47 46 46 47 47 47 46
46 46 46 46 47 47 46 47 47 47 47 46 47 46 47 46 47 46 47 46
46 46 46 46 46 46 46 46 46 46 47 46 47 46 47 46 46 46 46 46
REGION
0 0 0 0 0 0 0 0 0 0 0 0 0 0 0 0 0 0 0 0
0 0 0 0 0 0 0 0 0 0 0 0 0 0 0 0 0 0 0 0
2 2 2 2 2 2 2 2 2 2 2 2 2 2 2 2 2 2 2 2
2 2 2 2 2 2 2 2 2 2 2 2 2 2 2 2 2 2 2 2
2 2 2 2 2 2 2 2 2 2 2 2 2 2 2 2 2 2 2 2
0 0 1 1 1 1 1 1 1 1 1 1 1 1 1 1 0 0 0 0
0 0 1 1 1 1 1 1 1 1 1 1 1 1 1 1 0 0 0 0
0 0 1 1 1 1 1 1 1 1 1 1 1 1 1 1 0 0 0 0
0 0 1 1 1 1 1 1 1 1 1 1 1 1 1 1 0 0 0 0
0 0 1 1 1 1 1 1 1 1 1 1 1 1 1 1 0 0 0 0
0 0 1 1 1 1 1 1 1 1 1 1 1 1 1 1 0 0 0 0
0 0 1 1 1 1 1 1 1 1 1 1 1 1 1 1 0 0 0 0
