MERGE_DEFENDERS_LEVEL_V1
20 12
MAP
46 46 47 46 46 48 46 46 47 46 46 46 47 46 46 46 46 46 46 46
41 43 46 47 12 18 18 18 18 19 47 46 46 12 18 18 18 18 14 46
31 33 46 46 6 40 46 46 46 46 47 46 46 6 47 46 46 40 6 48
46 46 48 46 6 46 46 49 50 46 46 46 46 6 46 48 12 18 4 46
48 47 12 18 4 46 46 44 45 46 12 18 18 4 46 46 6 46 46 47
46 46 6 46 46 46 46 46 46 46 6 40 46 46 48 46 2 18 14 46
47 46 6 47 46 47 46 46 12 18 4 46 46 47 46 46 46 46 6 46
46 46 6 46 40 12 18 18 4 46 46 48 46 46 12 18 18 18 4 46
46 48 2 18 18 4 46 46 46 47 46 47 46 46 2 18 18 18 18 18
46 46 46 47 46 46 46 47 46 46 46 46 46 46 46 47 47 46 48 47
46 47 48 46 47 47 48 46 46 47 47 46 46 47 46 46 47 47 46 46
46 46 46 46 46 46 47 46 46 46 48 46 46 46 46 46 46 46 47 47
REGION
0 0 0 0 0 0 0 0 0 0 0 0 0 0 0 0 0 0 0 0
0 0 0 0 7 7 7 7 7 3 0 0 0 5 6 6 6 6 6 0
0 0 0 0 4 0 1 1 1 1 0 0 0 5 1 1 1 0 4 0
0 0 0 0 4 1 1 1 1 1 0 0 0 5 1 1 7 7 4 0
0 0 7 7 4 1 1 1 1 1 5 6 6 6 1 1 4 0 0 0
0 0 4 1 1 1 1 1 1 1 5 0 0 1 1 1 4 6 6 0
0 0 4 1 1 1 1 1 5 6 6 0 0 1 1 1 1 1 4 0
0 0 4 1 0 5 6 6 6 0 0 0 0 1 7 7 7 7 4 0
0 0 4 6 6 6 0 0 0 0 0 0 0 1 4 6 6 6 6 2
0 0 0 0 0 0 0 0 0 0 0 0 0 1 1 1 1 1 0 0
0 0 0 0 0 0 0 0 0 0 0 0 0 0 0 0 0 0 0 0
0 0 0 0 0 0 0 0 0 0 0 0 0 0 0 0 0 0 0 0
