MERGE_DEFENDERS_LEVEL_V1
20 12
MAP
46 46 6 46 46 46 46 46 46 46 46 46 46 46 46 46 46 46 46 46
46 46 6 46 46 46 46 46 46 46 46 46 46 46 46 46 46 46 46 46
46 46 6 46 46 46 46 46 46 46 46 46 46 46 46 46 46 46 46 46
46 46 6 46 46 46 46 12 18 18 18 18 18 14 46 46 46 46 46 46
46 46 6 46 46 46 46 6 46 46 46 46 46 6 46 46 46 46 46 46
46 46 6 46 46 46 46 6 46 46 46 46 46 6 46 46 46 46 46 46
46 46 6 46 46 46 46 6 46 46 46 46 46 2 18 18 18 19 46 46
46 46 2 18 18 18 18 4 46 46 46 46 46 46 46 46 46 46 46 46
46 46 46 46 46 46 46 46 46 46 46 46 46 46 46 46 46 46 46 46
46 46 46 46 46 46 46 46 46 46 46 46 46 46 46 46 46 46 46 46
42 42 42 42 42 42 42 42 42 42 42 42 42 42 42 42 42 42 42 42
37 37 37 37 37 37 37 37 37 37 37 37 37 37 37 37 37 37 37 37
REGION
0 0 2 0 0 0 0 0 0 0 0 0 0 0 0 0 0 0 0 0
0 0 5 0 0 0 0 0 0 0 0 0 0 0 0 0 0 0 0 0
0 0 5 0 0 0 0 0 0 0 0 0 0 0 0 0 0 0 0 0
0 0 5 0 0 0 0 7 7 7 7 7 7 5 0 0 0 0 0 0
0 0 5 0 0 0 0 4 1 1 1 1 1 5 0 0 0 0 0 0
0 0 5 0 0 0 0 4 1 1 1 1 1 5 0 0 0 0 0 0
0 0 5 0 0 0 0 4 1 1 1 1 1 7 7 7 7 3 0 0
0 0 7 7 7 7 7 4 0 0 0 0 0 0 0 0 0 0 0 0
0 0 0 0 0 0 0 0 0 0 0 0 0 0 0 0 0 0 0 0
0 0 0 0 0 0 0 0 0 0 0 0 0 0 0 0 0 0 0 0
0 0 0 0 0 0 0 0 0 0 0 0 0 0 0 0 0 0 0 0
0 0 0 0 0 0 0 0 0 0 0 0 0 0 0 0 0 0 0 0
